/-----!-----\
[           ]
[           ]
[           ]
[           ]
[           ]
[           ]
[           ]
(_____?_____)
