/!--------\
[         ]
[         ]
[123413   ]
[         ]
[         ]
[   132142]
[c        ]
(_______?_)
