/-----!-----\
[         78]
[ 1  3     c]
[      3    ]
[   4       ]
[       2   ]
[    2      ]
[ 6      2  ]
(_____?_____)
