/-----!-----\
[b          ]
[1213511211 ]
[           ]
[ 2212242252]
[           ]
[1151311211 ]
[b          ]
(_____?_____)
