/-!--\.............
[     ---\.........
[         ----\....
[              ---\
[                 ]
~                 =
[              ___)
[         ____)....
[     ___).........
(_?__).............
