/-------------\
[             ]
[             ]
[             ]
~             ]
[             ]
[             ]
[             ]
(_____________)
