/---------\
[688888886]
[8       8]
~    78CC8]
[8       8]
[688888886]
(_________)
