/----].............
[     ---].........
[         ----]....
[              ---]
[          a   a  ]
[66          A    ]
[            a ___]
[    6    ____]....
~    6___].........
(____].............
