/----].............
[  1 C---].........
~  2      ----]....
[  3        a  ---]
[  2     d       B]
[  5             B]
[  2        a ____]
[        ____]....
[     ___].........
(____].............
