....../---\......
..../-     -\....
../-         -\..
/-66       D   -\
~     6   DdD   ]
(_66       D   _)
..(_         _)..
....(_     _)....
......(___)......
