....../---\......
..../-     -\....
../-      6  -\..
/-         6Cb -\
~       D  6  78]
(_         6Cb _)
..(_      6  _)..
....(_     _)....
......(___)......
