/---------!-------\
[                 ]
[                 ]
.(               ).
..(             )..
...(           )...
....(         )....
.....(_______).....
