/---------!------\
[                ]
[      3213      ]
[  D   2661  C   ]
[      3123      ]
[C              C]
[________________]
