/---!---\
[a     a]
[       ]
[       ]
[       ]
[       ]
[       ]
[       ]
[a  B  a]
(_______)