/------!------\
[c           c]
[ 12123412122 ]
[      1      ]
[      2      ]
[     b2b     ]
[     B1B     ]
[  1221 1221  ]
[ c         c ]
(_____________)
