/---------!------\
(                )
.(              ).
..(            )..
...(          )...
....(A      A)....
.....(______).....