/-------------\
[             ]
[             ]
[             ]
~      D      =
[             ]
[             ]
[             ]
(_____________)
