/-------------\
[d           d]
[             ]
[             ]
~             =
[             ]
[             ]
[d           d]
(_____________)
