/-------------\
[        2 3  ]
[       3   2 ]
[1     1  c  1]
~ 2   2  132  =
[  113  3   31]
[3  c  1      ]
[ 3   1       ]
(_____________)
