/---------------\
[       3       ]
[      a1a      ]
[  1         1  ]
~  3    a    2  =
[  2         3  ]
[      a2a      ]
[       3       ]
(_______________)
