/-----!-----\
[C          ]
[    3124415]
~    2000000]
[    3212341]
[C          ]
(_____?_____)
