....../-!-\......
..../-     -\....
../-         -\..
/-          a  -\
~            d  ]
(_          a  _)
..(_         _)..
....(_     _)....
......(_?_)......
