/------------!---\
[    c        123]
[        c1213   ]
[     c3331c     ]
[   3213c        ]
[          2133  ]
[     c1231c     ]
[  1213c       d =
(____________?___)
