/--------!-------\
[1              1]
[ 223   21   232 ]
[                ]
[       DD       =
[  231      321  ]
[ 1     23     2 ]
[2              1]
(_______?________)
