....../-!-\......
..../-     -\....
../-24      c-\..
/-             -\
[C              =
(_134       c  _)
..(_       32_)..
....(_     _)....
......(_?_)......
