....../-!-\......
..../-6    -\....
../-        6-\..
/-           b -\
[      7D       =
(_            6_)
..(_ 66      _)..
....(_     _)....
......(_?_)......
