/----].............
[6    -!-].........
[         ----]....
[ a          6 ---\
[     60          ]
[0                =
[              ___]
[       a ____]....
[    0___].........
(_?__].............
