/----].............
[C     -!-].........
[         ----]....
[3          3  ---]
[           2     ]
[     1           =
[    a 2        ___]
[     1   ____]....
[     ___].........
(_?__].............
