/-----------------\
[                 ]
[                 ]
[                 ]
[                 ]
[                 ]
[                 ]
[                 =
[                 ]
(_________________)
