/-----------\
[         A ]
[ b         ]
[       6666]
[           =
[       6666]
[ b         ]
[         A ]
(___________)
