/-----------------\
[                ].
[ D             ]..
[  D           ]...
[ D            =...
[  D           ]...
[ D             ]..
[                ].
(_________________)
