/------------\./--\
[            ].[  ]
[  D         /-\  ]
[                 ]
[  C              =
[                 ]
[            /-\  ]
[  D         ].[  ]
(____________).(__)

