/-----------------\
[ a               ]
[             /-\ ]
[ a           ].[ ]
[     D       ].[ ]
[ a           ].[ ]
[             ].[ ]
[ a  B  B     ].[ =
(_____________).(_)
