/-----------\
[A         6]
[           ]
[  c24123   ]
[        c  =
[  c4123    ]
[     c2    ]
[b     1  78]
(_____?_____)
