/-----------\
[           ]
[  2    d   ]
[B4         ]
[3          =
[   d     42]
[        3  ]
[       2   ]
(_____?_____)
