/-----------------\
[                 =
[ a               ]
[        /________)
[   D    [.........
[        [.........
[        /--------\
[ a               ]
[                 ]
(_______________?_)
