/--.....----------\
[BB[...]          ]
[   [_]        D  ]
[                 ]
[             ----]
[               =..
[      ___________]
.[-               ]
..[               ]
.(_____________?__)
