/-------!--------\
(                )
.(              ).
..[            ]..
..~            =..
..(            )..
...(          )...
....(__     _)....
.......[   ]......
.......(_?_)......
