/-----!-----\
[           ]
[ d       d ]
[           ]
~           =
[           ]
[ d       d ]
[           ]
.___     ___.
....(_?_)....
