/---------!------\
[B              c]
[      1231      ]
~      3783c     =
[      2132      ]
[B              c]
(______?_________)
