/-------.--------\
(b     [.]      B)
.(     [.]      ).
..[  A [!]     ]..
..~            =..
..(            )..
...(a         )...
....(_?_    _)....
........[  ]......
........(__)......
