/--.....----------\
[bA[...]          ]
[   [!]    D      ]
[                 ]
[             ---].
[               =..
[      4      ___].
.[-    3          ]
..~    2          ]
.(________?_______)
