/-----!-----\
[           ]
[           ]
[           ]
~           =
[           ]
[           ]
[           ]
(___________)
