/-----!-----\
[    6 6    ]
[           ]
[6    3    6]
~   13542   =
[6   c3    6]
[     1     ]
[           ]
(___________)
