/-----!-----\
[           ]
[   32666678]
[      c6   ]
~        6  =
[   6       ]
[    6      ]
[  6   6    ]
(___________)
