/-----!-----\
[b7       8b]
[8         7]
[           ]
~     C    =
[           ]
[8         7]
[b7       8b]
(___________)
