/-----!-----\
[B 7      1 ]
[    8    5 ]
[   73   3  ]
~     b     =
[   9     52]
[ 88   43   ]
[   1      B]
(___________)
