/-----------\
[           ]
[           ]
[           ]
[           ]
[           ]
[           ]
[           ]
(_____?_____)
