/-----------\
[ 888888888 ]
[8         8]
[8  8   8  8]
[8         8]
[8    8    8]
[ 8       8 ]
[  8     8  ]
(_____?_____)
