/-----------\
[  88   88  ]
[ 8  8 8  8 ]
[  8  8  8  ]
[   8   8   ]
[    8 8    ]
[           ]
[           ]
(_____?_____)
