/-----------\
[d    d    d]
[           ]
[    888    ]
[d   8 8   d]
[    888    ]
[           ]
[d         d]
(_____?_____)
