/-----------\
[8   332   8]
[   2a a1   ]
[   3   4   ]
[   1a a1   ]
[    1 1    ]
[8         8]
(_____?_____)
