/----!----------\
[               ]
[               ]
[               ]
~               ]
[               ]
[               ]
[               ]
(_______________)
