/-------!--------\
[                ]
[  a         a   ]
[      1321      ]
~      1221      ]
[      2321      ]
[  a         a   ]
[                ]
(________________)
