/--------!-------\
[123B            ]
[b  231    c     ]
[      3121      ]
~      3231      ]
[      1212      ]
[    c       c   ]
[        c       ]
(________________)
