....../-!-\......
..../-     -\....
../-c        -\..
/-   c         -\
~     ccc       ]
(_             _)
..(_   ccc   _)..
....(_     _)....
......(___)......
