....../-!-\......
..../-     -\....
../-         -\..
/-           00-\
~       D    078]
(_           00_)
..(_00       _)..
....(_     _)....
......(___)......
