/----].............
[     ---].........
[         ----]....
[              -!-]
[    6 c6    c    ]
~    6            ]
[    6     6   ___]
[       6 ____]....
[   b ___].........
(____].............
