/----].............
[     ---].........
[  b      ----]....
[              -!-]
[                 ]
~       D         ]
[              ___]
[  b      ____]....
[     ___].........
(____].............
