/-----------\
[         c ]
[    666666 ]
[          6]
~  6        =
[          6]
[    666666 ]
[ B         ]
(_____?_____)
