/-----------\
[  1234241  ]
[ 3       2 ]
[           ]
~           =
[           ]
[  2      1 ]
[   3   2  B]
(_____?_____)
