/---------\
[   a a   ]
~         =
[         ]
(____?____)
