/-----------\
~  c     c  =
[           ]
[     c     ]
[           ]
(_____?_____)
