/-----------\
[b      412 ]
[           ]
[ 132  2b   ]
~    31     =
[           ]
[4 2      34]
[ b 1   12  ]
(_____?_____)
