/-----!-------\
[             ]
[             ]
[             ]
[             =
[             ]
[             ]
[             ]
(_____________)
