/-!---------\
[          1]
[         2 ]
[21344   3  ]
[b   c  5   =
[      3    ]
[c c122c   2]
[           ]
(___________)
