/---!-------\
[      6 B78]
[      6    ]
[      6    ]
[   D   6   =
[       6   ]
[ C     6   ]
[           ]
(___________)
