/-----]............
[     -!-].........
[        2----]....
[      34      ---]
[     23          ]
[       2    21   =
[  42451    A3 ___]
[          ___]....
[A    ____]........
(____].............
