/----].............
[8888 ---].........
[    8888 ----]....
[        8888  -!-]
[ d d             ]
[  D         8    =
[  d           ___]
[         ____]....
[8888 ___].........
(____].............
