....../-!-\......
..../-     -\....
../-66     66-\..
/-  6       6  -\
[A      D       =
(_  6       6  _)
..(_66     66_)..
....(_  B  _)....
......(___)......
