....../!--\......
..../-     -\....
../-       8 -\..
/-             -\
[C  8           =
(_        8    _)
..(_  C      _)..
....(_ 786 _)....
......(___)......
