/---------------\
[               ]
[               ]
[               ]
~               ]
[               ]
[               ]
[               ]
(_____?_________)
