/-----------\
[         a ]
[    c      ]
[  2123  321]
~  3        ]
[122  2132  ]
[ B   2  c  ]
[   12      ]
(_____?_____)
