/-----------\
[           ]
[    6666   ]
[   6       ]
~  6  D     ]
[6666   6666]
[ b6     6b ]
[ 6       6 ]
(_____?_____)
