....../---\......
..../-     -\....
../-         -\..
/-     d d     -\
~       d       ]
(_             _)
..(_         _)..
....(_     _)....
......(_?_)......
