....../---\......
..../-     -\....
../-       c -\..
/-       3  c  -\
~        22 c   ]
(_ 1342413  c  _)
..(_       c _)..
....(_     _)....
......(__?)......
