/----].............
[     ---].........
[         ----]....
[    6         ---]
[    66b b        ]
~    666666666    ]
[    66         __]
[      66 _?___]...
[     ___].........
(____].............
