/----].............
[     ---].........
[         ----]....
[              ---]
[       314       ]
~   5123   341ccc ]
[1234           __]
[         _____]...
[     ___].........
(_?__].............
